#           B
# ########## 
# #        # 
# # ###### # 
#   #      # 
### # ###### 
A   #        